0 4 0 0 0 0 0 1
1 0 0 1 3 0 0 0
0 0 0 0 0 0 0 2
5 3 0 0 1 0 1 0
0 0 3 0 1 1 0 1
5 1 1 0 1 0 0 0
0 1 0 3 0 1 0 0
3 0 0 0 0 0 1 0
